命令如下:[每个参数中介加空格]

领外卖红包:    外卖   美团  饿了么  吃饭
二维码生成： 二维码 http(s)://xxx.xxx
网易云解析： 网易云 歌曲ID
中英文翻译:  翻译 XXX
查询陌生字:  查字 X
动漫在线看:  动漫 动漫名称
在线短视频:  XX短视频  #明星短视频  风景短视频
举牌小矮人:  举牌 XXX
影视在线看:  搜 片名  »看 片名 序号
在线听音乐:  (搜歌 歌名 » 听 歌名 序号
在线听音乐:  音乐 歌名
王者出装查：  王者 英雄名
玩成语接龙:  成语接龙 »  接 XXXX
查天气预报:  XXXX天气  
查垃圾分类:  垃圾分类 抽纸 
查百度百科:  百科 666  
IP网址ping:   ping http(s)://xxx.xxx
域名查收录:    收录查询 http(s)://xxx.xxx
搜索🔍内容:   搜索  完美世界
另其他功能:   
获取上车地址:  上车
和小爱对话:    小爱/喵喵*****
手机号查询:   查询手机号  ******
ip查询 :     ip查询  *****

文字类:  
历史上的今天  鸡汤   毒鸡汤    骚话   我在人间凑数的日子  舔狗  网易云热评

图片类:  
姐姐  妹妹  妹子1  妹子2  腿控  换一个/再换  漫图  随机1  随机2  壁纸  美图诱惑  cos美图  bing美图  色图  涩图  买家秀  秀儿  美腿  日历  二次元1  二次元2  二次元3  今日要闻/世界新闻/一分钟看世界  早安  头像男  头像女  


音频类:  
营养视频  新歌榜  热歌榜  抖音榜  飙升榜

